###########
#A     #  #
# ## # # ##
# #  # # ##
# ### # ##
# #     ##
#   #####B#
# ## ### ##
# ##     ##
###########
