######################
#A                   #
# ####### ######### ##
# #     # #       # ##
# # ### # # ##### # ##
# # #   # #     # # ##
# # ### # ##### # # ##
# # #   #       # # ##
# # ### ######### # ##
# #   #         #   ##
## ## # #########  ###
#    # #       # #  B#
######################
