###########
#A       ##
## ## ## ##
## ## ## ##
## ## ## ##
## ## ## ##
## ## ## ##
## ## ## ##
## ## ## ##
## ##    B#
###########
